hasfirstsubevent	hasfirstsubevent
partof	partof
receivesaction	receivesaction
usedfor	usedfor
nothasproperty	nothasproperty
antonym	antonym
formof	formof
createdby	createdby
locatednear	locatednear
motivatedbygoal	motivatedbygoal
causes	causes
hasprerequisite	hasprerequisite
notcapableof	notcapableof
synonym	synonym
distinctfrom	distinctfrom
derivedfrom	derivedfrom
relatedto	relatedto
isa	isa
dbpedia	dbpedia
notdesires	notdesires
hascontext	hascontext
instanceof	instanceof
desires	desires
atlocation	atlocation
madeof	madeof
mannerof	mannerof
hassubevent	hassubevent
entails	entails
haslastsubevent	haslastsubevent
similarto	similarto
causesdesire	causesdesire
definedas	definedas
etymologicallyrelatedto	etymologicallyrelatedto
hasproperty	hasproperty
hasa	hasa
capableof	capableof
